# Map file for RoboLab
# (Lines that start with '#' are comments)
#
# The tiles are:
#   A..Z    Tiles A through Z
#   *       Start
#
# Paint strokes kan be added in the according list
# by adding tuples of the form: ([color],[type],[x],[y])
#
# [color] :   w = white
#             b = black
# [type]  :   . = single dot
#             - = horizontal stroke to the right
#             | = vertical stroke down
# [x]     :   integer horizontal position
# [y]     :   integer vertical position

paint:
{}

map:
AAAAAAAAAAAAAAAAAAAAAAAAAAAAAAAAAAAAAAAAAAAAAAAAAAAAAAAAAAAAA
A@    A     A       A     A       A A           A           A
A AAA AAA A AAAAA A A A A A A AAA A A AAAAAAA A AAAAAAA AAA A
A A     A A     A A   A A A A   A A   A       A       A  *A A
A AAAAA A AAAAA AAAAA A AAA AAA A AAAAA AAAAAAAAAAAAA AAAAA A
A   A   A A   A A   A A A   A   A     A         A A   A     A
A A A AAA A AAA A A AAA A AAA AAAAAAA AAA AAAAA A A AAA AAA A
A A A   A A   A   A   A   A   A     A   A   A   A A A   A   A
A A AAA A AAA AAAAAAA AAAAA AAAAA A AAA AAA A AAA A AAA AAAAA
A A A   A   A           A   A     A A   A   A A   A A   A   A
AAA A AAAAA A AAAAAAAAA A AAAAA AAA A AAAAAAA A AAA A A A A A
A   A A   A A   A     A   A   A   A A         A     A A A A A
A AAA A A A AAAAA AAA AAAAA A AAA AAAAAAAAAAAAA AAAAA AAA A A
A A     A A         A       A   A         A     A       A A A
A AAAAAAA AAAAA AAAAAAAAA AAAAA A AAAAA A A AAAAAAA AAA A A A
A   A   A     A A A     A A     A A A   A A A     A A A   A A
A A AAA AAAAA A A A AAA A A AAAAA A A AAAAA AAA A A A AAAAA A
A A A     A A A   A A A A A A   A   A     A A   A A   A     A
AAA A AAA A A AAAAA A A AAA A A AAAAA AAA A A AAA AAAAA AAA A
A   A   A A A     A A   A   A A     A   A A   A A A     A A A
A AAA A A A AAAAA A A AAA A A AAAAA AAA A AAAAA A A AAAAA A A
A A   A A     A A   A A   A A A   A   A A         A     A A A
A A AAA AAAAA A AAAAA AAA A A A A AAA AAA AAAAAAAAAAAAA A A A
A A   A     A   A   A A   A A A A   A   A             A A   A
A AAAAAAA A AAAAA A A A AAA A AAAAA AAA AAAAAAA AAAAA A A AAA
A   A   A A   A   A A   A   A     A   A   A   A A   A   A A A
A A A A AAAAA A AAA AAAAA AAAAAAA AAA AAA A A AAA A AAAAA A A
A A A A       A   A       A     A   A   A A A     A A   A   A
A A A AAAAAAAAAAA AAAAAAAAA AAA AAA A AAA A AAAAAAA A AAAAA A
A A A A         A     A     A A     A A   A   A   A A   A   A
A A A A AAAAAAA AAAAA A AAAAA AAAAAAA A AAAAA AAA A AAA A AAA
A A A A A     A       A A           A A       A   A   A   A A
A A A A AAA AAAAA AAAAA AAA AAA AAA A AAAAAAAAA AAAAA A AAA A
A A A A     A   A A   A   A A   A   A       A       A A     A
A A A AAA AAA A A A A AAA A A AAA AAAAA AAA AAAAA A A AAAAA A
A A A     A   A A A A     A A A   A     A   A     A A   A A A
AAA A AAAAA AAA A A AAAAAAAAA A AAA AAAAA AAA AAAAA AAA A A A
A   A A   A   A A A           A     A     A   A     A   A   A
A AAAAA A AAA A AAAAAAAAAAAAAAAAAAAAA AAAAA AAA AAAAA AAAAAAA
A       A     A   A             A     A     A     A   A     A
A AAAAAAAAAAAAAAA A AAAAA A AAAAA AAAAA AAA A AAAAA AAA AAA A
A     A         A   A     A A   A   A     A A A   A     A   A
AAAAA A AAAAAAA AAAAA A AAAAA A AAA AAAAAAA AAA A AAAAAAA A A
A   A A A A     A A   A A   A A   A A     A A   A       A A A
AAA A A A A AAAAA A AAAAA A A A AAA A AAA A A AAAAAAAAA A AAA
A   A A A   A     A   A   A   A   A A A     A A       A A   A
A A A A A AAA AAA AAA A AAAAAAAAA A A AAAAA A A A AAA A A A A
A A A   A A     A   A   A     A A   A   A   A A A   A A A A A
A AAAAAAA A AAA AAA AAAAA A A A AAAAAAA A AAA A AAA A AAAAA A
A A     A A   A   A     A A A A         A   A A A A A       A
A A AAA A AAAAA A AAAAAAA A A AAA AAAAAAAAA A A A A AAAAAAA A
A A A   A     A A A   A   A A   A A       A A A   A     A   A
A A A AAAAAAA AAA A A A AAA AAA A A A AAA A A AAAAA AAA A AAA
A A A A       A   A A     A A A A A A A   A A A   A   A A   A
A A A A AAAAAAA A A AAAAAAA A A A AAA AAA A A A A AAA A AAAAA
A   A   A     A A A A     A A   A   A   A A A   A   A A     A
A AAAAAAA AAA A AAA A AAA A A AAAAA AAA A A AAAAAAA A AAAAA A
A     A   A   A     A A A   A   A   A   A A A     A A     A A
AAAAA AAA A AAAAAAAAA A AAAAAAA A AAA AAAAA AAAAA A AAAAAAA A
A         A           A           A               A         A
AAAAAAAAAAAAAAAAAAAAAAAAAAAAAAAAAAAAAAAAAAAAAAAAAAAAAAAAAAAAA
