# Map file for RoboLab
# (Lines that start with '#' are comments)
#
# The tiles are:
#   A..Z    Tiles A through Z
#   *       Start
#
# Paint strokes kan be added in the according list
# by adding tuples of the form: ([color],[type],[x],[y])
#
# [color] :   w = white
#             b = black
# [type]  :   . = single dot
#             - = horizontal stroke to the right
#             | = vertical stroke down
# [x]     :   integer horizontal position
# [y]     :   integer vertical position
 
paint:
{}

map:
AAAAAAAAAAAAAAAAAAAAAAAAAAAAAAAAAAAAAAAAAAAAAAA
A     A   A A  AAAA A  AA     AA AAA AA  A    A
AAAAA A AAA   AA      AA  AA  A   A     AAAA AA
A        A  A  A  AA  A  AA  AAAA AA AA A  A  A
A AAAAA AAAAA  AAAA  AA   A     A    A* A     A
A A       A   AA  AA  A A A  AA AAAA AAAA A A A
A AA AAAA AA   AA  A    AAA   A    A      A A A
A       A  AA   AA   AA A    AA  A AAAA AAA AAA
A AAAAA AA  AAA  A   A   AAA    AA    AAAA    A
A A      A AA A  AAA AAA   A AAAAA  AAA A  AA A
A AA AAA A A     A   A    AA A AA   A   AA    A
A AA A A     AA AA  AA AAAA     AA AAA   AAAA A
A      AAAA  A   AAAAAAA    AA   A   A A  A   A
AAAAA  AA    AA     AA   AAAA  AAA  AA AA AA  A
A   A AA  AA  AAA A    AAA      A      AA  A  A
A A    AA AA    A AAAA AAAA AA AAAAAA AA  AA AA
A A@A     A  AA     A       A          A      A
AAAAAAAAAAAAAAAAAAAAAAAAAAAAAAAAAAAAAAAAAAAAAAA

