#map:def
paint:
(w,.,10,7)
(w,.,17,7)


extra:
palm@4,5
palm@16,11
palm@5,14
palm@22,1
palm@26,13

map:
AAAAAA    Q           AAAAAAA
A    A      AAAAAAAAA ARA   A
A    AAAAAAAA       A ARA   A
A           A   PAAAAAAAA   A
A     AAA   A           A   A
AAAAAAARA   A           A   A
      ARA   AAAAAAAAAP  A   A
AAAAAAARA               A   A
A     ARA               A   A
A     AAA        @      PO  A
A  OO                       A
A  OO     * P   AAAAAAAAA   A
A      P    AAAAA   A   A   A
A      A            A O AAAAA
AAAAAAAAAAAAAAAA    A   ARA
       A       AAP      ARA
  Q    A             AAAARA
   Q   A             ARRRRA
       AAAAAAAA    AAAAAAAA
              AAAAAA